54,55,55,55,55,55,55,55,55,55,55,55,55,55,56
57,34,28,34,34,34,34,34,34,34,34,34,34,34,59
57,34,34,34,34,34,34,34,34,34,34,30,34,34,59
57,34,34,30,34,34,34,34,34,34,34,34,28,34,59
57,28,34,34,34,34,34,28,34,34,34,34,34,34,59
57,34,34,34,34,34,34,34,34,34,34,34,34,34,59
57,34,34,34,34,34,34,34,34,34,29,34,34,34,59
57,34,30,34,34,34,34,37,34,34,34,34,34,34,59
57,34,34,34,34,34,34,34,34,34,34,34,34,34,59
57,34,34,34,34,34,34,29,34,31,34,34,34,34,59
57,34,34,30,34,34,34,34,34,34,28,34,34,34,59
57,34,34,34,34,34,34,34,34,34,34,34,34,34,59
57,34,34,34,34,34,29,34,34,34,34,30,34,34,59
57,34,34,34,28,34,34,34,34,34,34,34,34,34,59
60,61,61,61,61,61,61,61,61,61,61,61,61,61,62