54,55,55,55,55,55,55,55,55,55,55,55,55,55,56
57,0,0,0,0,0,0,6,0,0,0,0,0,0,59
57,0,0,7,0,0,0,0,0,0,0,0,5,0,59
57,0,0,0,0,0,0,0,1,0,0,0,0,0,59
57,0,0,0,0,0,0,0,0,0,0,0,0,0,59
57,0,0,0,0,0,0,0,0,0,0,0,0,0,59
57,0,0,4,0,0,0,0,0,0,0,0,0,0,59
57,0,0,0,0,0,0,90,0,0,0,0,0,0,59
57,0,0,0,0,0,0,0,0,0,0,2,0,0,59
57,0,0,0,0,0,0,0,0,0,0,0,0,0,59
57,0,0,0,0,0,0,0,0,0,0,0,0,0,59
57,0,12,0,0,0,0,0,0,0,0,0,0,0,59
57,0,0,0,0,0,0,0,0,0,10,0,0,0,59
57,0,0,0,0,0,0,0,0,0,0,0,0,0,59
60,61,61,61,61,61,61,61,61,61,61,61,61,61,62