54,55,55,55,55,55,13,13,13,55,55,55,55,55,56
57,13,14,13,13,15,13,14,13,13,13,14,13,13,59
57,14,13,13,13,13,14,13,13,15,13,13,13,13,59
57,13,15,13,14,13,13,13,13,13,13,13,14,13,59
57,0,3,0,0,0,5,0,0,0,0,6,0,5,59
57,0,0,0,5,0,0,0,0,3,0,0,0,0,59
57,5,0,0,0,0,6,0,0,0,0,0,3,0,59
57,0,0,0,3,0,0,0,0,0,6,0,0,0,59
57,32,32,32,32,32,32,32,30,32,32,31,32,29,59
57,32,30,32,32,32,32,32,32,32,32,30,32,32,59
57,32,31,32,32,67,41,41,41,68,32,32,29,32,59
57,29,32,30,32,32,32,32,32,32,32,32,32,32,59
57,23,23,23,23,23,23,23,23,23,23,23,23,23,59
57,23,23,23,23,23,23,23,23,23,23,23,23,23,59
57,23,23,23,23,23,23,23,23,23,23,23,23,23,59