54,55,55,55,55,55,55,55,55,55,55,55,55,55,56
57,13,13,13,13,17,13,13,13,13,13,13,13,13,59
57,13,14,13,13,13,15,13,13,13,14,13,13,13,59
57,13,13,13,13,13,13,13,13,13,13,13,16,13,59
57,13,13,13,13,13,13,13,13,13,13,13,14,13,59
57,13,13,13,13,17,13,13,13,13,13,13,13,13,59
57,13,13,13,13,13,18,29,19,13,15,13,13,13,59
57,13,15,13,13,13,30,46,34,13,13,13,13,13,59
57,13,13,13,13,13,20,28,21,13,13,13,15,13,59
57,13,13,13,13,13,13,13,13,13,13,13,13,13,59
57,13,13,14,13,13,13,13,13,13,13,16,13,13,59
57,13,13,13,13,13,13,13,14,13,13,13,13,13,59
57,13,13,13,13,13,13,13,13,13,13,13,17,13,59
57,13,15,13,13,13,13,13,13,13,13,13,13,13,59
60,61,61,61,61,61,61,61,61,61,61,61,61,61,62